NO ./path_to_the_north_texture
SO ./path_to_the_south_texture
EA ./path_to_the_east_texture
WE ./path_to_the_west_texture
C 220,100,50
F 225,30,0

11111
10001
10N01
11111
